+   -   -   -   -   -   -   -   -   -   -   -   -   -   -   -   -   -   -   -   -   -   -   -   -   +
|   v   v   v   v   v   v   v   v   v   v   v   v   v   v   v   v   v   v   v   v   v   v   v   v   |
|   v   v   v   v   v   v   v   v   v   v   v   v   v   v   v   v   v   v   v   v   v   v   v   v   |
|   v   v   v   v   v   v   v   v   v   v   v   v   v   v   v   v   v   v   v   v   v   v   v   v   |
|   v   v   v   v   v   v   v   v   v   v   v   v   v   v   v   v   v   v   v   v   v   v   v   v   |
|   v   v   v   v   v   v   v   v   v   v   v   v   v   v   v   v   v   v   v   v   v   v   v   v   |
|   v   v   v   v   v   v   v   v   v   v   v   v   v   v   v   v   v   v   v   v   v   v   v   v   |
|   v   v   v   v   v   v   v   v   v   v   v   v   v   v   v   v   v   v   v   v   v   v   v   v   |
|   v   v   v   v   v   v   v   v   v   v   v   v   v   v   v   v   v   v   v   v   v   v   v   v   |
|   v   v   v   v   v   v   B   I   Y   v   v   v   v   v   F   I   !   v   v   v   v   v   v   v   |
|   v   v   v   v   v   v   v   v   v   v   v   v   v   v   v   v   v   v   v   v   v   v   v   v   |
|   v   v   v   v   v   v   w   w   w   w   w   w   w   w   w   w   w   v   v   v   v   v   v   v   |
|   v   v   v   v   v   v   f   f   f   f   f   r   f   f   f   f   f   v   v   v   v   v   v   v   |
|   v   v   v   v   v   v   f   f   f   f   f   r   f   f   f   f   f   v   v   v   v   v   v   v   |
|   v   v   v   v   v   v   f   f   f   f   f   r   f   f   f   f   f   v   v   v   v   v   v   v   |
|   v   v   v   v   v   v   w   w   w   w   w   w   w   w   w   w   w   v   v   v   v   v   v   v   |
|   v   v   v   v   v   v   v   v   v   v   v   v   v   v   v   v   v   v   v   v   v   v   v   v   |
|   v   v   v   v   v   v   W   I   S   v   v   v   v   v   R   I   P   v   v   v   v   v   v   v   |
|   v   v   v   v   v   v   v   v   v   v   v   v   v   v   v   v   v   v   v   v   v   v   v   v   |
|   v   v   v   v   v   v   v   v   v   v   v   v   v   v   v   v   v   v   v   v   v   v   v   v   |
|   v   v   v   v   v   v   v   v   v   v   v   v   v   v   v   v   v   v   v   v   v   v   v   v   |
|   v   v   v   v   v   v   v   v   v   v   v   v   v   v   v   v   v   v   v   v   v   v   v   v   |
|   v   v   v   v   v   v   v   v   v   v   v   v   v   v   v   v   v   v   v   v   v   v   v   v   |
|   v   v   v   v   v   v   v   v   v   v   v   v   v   v   v   v   v   v   v   v   v   v   v   v   |
|   v   v   v   v   v   v   v   v   v   v   v   v   v   v   v   v   v   v   v   v   v   v   v   v   |
+   -   -   -   -   -   -   -   -   -   -   -   -   -   -   -   -   -   -   -   -   -   -   -   -   +
